IMKJHFJBMEB=PlayerHandler
DJOOHHIQGJK=CharacterHandler
DOMONILEIKL=MapDownloader
MCNLIHMMLCF=MapManager
GDDKPIHHICF=TCPConnection
KOJBBGEINPH=LootboxHandler
DNFENPQLICQ=SkinHandler
MBGHQMKEFKO=ChatHandler
GBQODOBKJBG=AreaPokemonHandler
LQCPKKCJPPB=PrivateMessageHandler
CGOIPHKQMPD=NetworkPlayerHandler
INFJMNPKNQF=InventoryHandler
NBQDPNGNNML=QuestHandler
HFCMDEQKCKH=PokemonHandler
DBQLOHBBJMG=BattlePacketHandler
OGIHGEJKOGL=AccountHandler
JJGLMJNELOK=PokeboxHandler
PJCCMHCDFJQ=TradeHandler
DCJIBBJQGJP=PartyHandler
CKMLKNPNPQO=SocialHandler
BDLNNJFQOQH=BattleLobbyHandler
IBJOGQJFQEP=LootManager
QOHCEBMQKMB=ScriptHandler
JPPCMGBCNNJ=AchievementHandler
HDQHPMCPDNJ=StatHandler
NOHEMGHONKK=GuildHandler
OGJJKKQPNMK=BattleHandler
BNJJIOHLOIC=AreaPokemon
KJMPLFDOBCO=LearnHandler
NHPGIPEOKID=ChatboxInput
BNIJKFJBFBG=CustomizationHandler
IMKCQDFNGBD=ChunkInfo
JECQIFOKKGG=EvolutionHandler
KGQECFKLKOP=PSXUtilities